ABS=ABS
ACOS=ARCCOS
ACOSH=ARCCOSHYP
ADDRESS=ADRESSE
AND=UND
AREAS=BEREICHE
ASIN=ARCSIN
ASINH=ARCSINHYP
ATAN=ARCTAN
ATAN2=ARCTAN2
ATANH=ARCTANHYP
AVEDEV=MITTELABW
AVERAGE=MITTELWERT
AVERAGEA=MITTELWERTA
BETADIST=BETAVERT
BETAINV=BETAINV
BINOMDIST=BINOMVERT
CEILING=OBERGRENZE
CELL=ZELLE
CHAR=ZEICHEN
CHIDIST=CHIVERT
CHIINV=CHIINV
CHITEST=CHITEST
CHOOSE=WAHL
CLEAN=SÄUBERN
CODE=CODE
COLUMN=SPALTE
COLUMNS=SPALTEN
COMBIN=KOMBINATIONEN
CONCATENATE=VERKETTEN
CONFIDENCE=KONFIDENZ
CORREL=KORREL
COS=COS
COSH=COSHYP
COUNT=ANZAHL
COUNTA=ANZAHL2
COUNTBLANK=ANZAHLLEEREZELLEN
COUNTIF=ZÄHLENWENN
COVAR=KOVAR
CRITBINOM=KRITBINOM
DATE=DATUM
DATEVALUE=DATWERT
DAVERAGE=DBMITTELWERT
DAY=TAG
DAYS360=TAGE360
DB=GDA2
DCOUNT=DBANZAHL
DCOUNTA=DBANZAHL2
DDB=GDA
DEGREES=GRAD
DEVSQ=SUMQUADABW
DGET=DBAUSZUG
DMAX=DBMAX
DMIN=DBMIN
DOLLAR=DM
DPRODUCT=DBPRODUKT
DSTDEV=DBSTDABW
DSTDEVP=DBSTDABWN
DSUM=DBSUMME
DVAR=DBVARIANZ
DVARP=DBVARIANZEN
ERROR.TYPE=FEHLER.TYP
EVEN=GERADE
EXACT=IDENTISCH
EXP=EXP
EXPONDIST=EXPONVERT
FACT=FAKULTÄT
FALSE=FALSCH
FDIST=FVERT
FIND=FINDEN
FINV=FINV
FISHER=FISHER
FISHERINV=FISHERINV
FIXED=FEST
FLOOR=UNTERGRENZE
FORECAST=SCHÄTZER
FREQUENCY=HÄUFIGKEIT
FTEST=FTEST
FV=ZW
GAMMADIST=GAMMAVERT
GAMMAINV=GAMMAINV
GAMMALN=GAMMALN
GEOMEAN=GEOMITTEL
GETPIVOTDATA=GETPIVOTDATA
GROWTH=VARIATION
HARMEAN=HARMITTEL
HLOOKUP=WVERWEIS
HOUR=STUNDE
HYPERLINK=HYPERLINK
HYPGEOMDIST=HYPGEOMVERT
IF=WENN
INDEX=INDEX
INDIRECT=INDIREKT
INFO=INFO
INT=GANZZAHL
INTERCEPT=ACHSENABSCHNITT
INTERSECT=INTERSECT
IPMT=ZINSZ
IRR=IKV
ISBLANK=ISTLEER
ISERR=ISTFEHL
ISERROR=ISTFEHLER
ISLOGICAL=ISTLOG
ISNA=ISTNV
ISNONTEXT=ISTKTEXT
ISNUMBER=ISTZAHL
ISPMT=ISPMT
ISREF=ISTBEZUG
ISTEXT=ISTTEXT
KURT=KURT
LARGE=KGRÖSSTE
LEFT=LINKS
LEN=LÄNGE
LINEST=RGP
LN=LN
LOG=LOG
LOG10=LOG10
LOGEST=RKP
LOGINV=LOGINV
LOGNORMDIST=LOGNORMVERT
LOOKUP=VERWEIS
LOWER=KLEIN
MATCH=VERGLEICH
MAX=MAX
MAXA=MAXA
MDETERM=MDET
MEDIAN=MEDIAN
MID=TEIL
MIN=MIN
MINA=MINA
MINUTE=MINUTE
MINVERSE=MINV
MIRR=QIKV
MMULT=MMULT
MOD=REST
MODE=MODALWERT
MONTH=MONAT
N=N
NA=NV
NEGBINOMDIST=NEGBINOMVERT
NORMDIST=NORMVERT
NORMINV=NORMINV
NORMSDIST=STANDNORMVERT
NORMSINV=STANDNORMINV
NOT=NICHT
NOW=JETZT
NPER=ZZR
NPV=NBW
ODD=UNGERADE
OFFSET=BEREICH.VERSCHIEBEN
OR=ODER
PEARSON=PEARSON
PERCENTILE=QUANTIL
PERCENTRANK=QUANTILSRANG
PERMUT=VARIATIONEN
PI=PI
PMT=RMZ
POISSON=POISSON
POWER=POTENZ
PPMT=KAPZ
PROB=WAHRSCHBEREICH
PRODUCT=PRODUKT
PROPER=GROSS2
PV=BW
QUARTILE=QUARTILE
RADIANS=RADIANT
RAND=ZUFALLSZAHL
RANK=RANG
RATE=ZINS
REPLACE=ERSETZEN
REPT=WIEDERHOLEN
RIGHT=RECHTS
ROMAN=RÖMISCH
ROUND=RUNDEN
ROUNDDOWN=ABRUNDEN
ROUNDUP=AUFRUNDEN
ROW=ZEILE
ROWS=ZEILEN
RSQ=BESTIMMTHEITSMASS
RTD=RTD
SEARCH=SUCHEN
SECOND=SEKUNDE
SIGN=VORZEICHEN
SIN=SIN
SINH=SINHYP
SKEW=SCHIEFE
SLN=LIA
SLOPE=STEIGUNG
SMALL=KKLEINSTE
SQRT=WURZEL
STANDARDIZE=STANDARDISIERUNG
STDEV=STABW
STDEVA=STABWA
STDEVP=STABWN
STDEVPA=STABWNA
STEYX=STFEHLERYX
SUBSTITUTE=WECHSELN
SUBTOTAL=TEILERGEBNIS
SUM=SUMME
SUMIF=SUMMEWENN
SUMPRODUCT=SUMMENPRODUKT
SUMSQ=QUADRATESUMME
SUMX2MY2=SUMMEX2MY2
SUMX2PY2=SUMMEX2PY2
SUMXMY2=SUMMEXMY2
SYD=DIA
T=T
TAN=TAN
TANH=TANHYP
TDIST=TVERT
TEXT=TEXT
TIME=ZEIT
TIMEVALUE=ZEITWERT
TINV=TINV
TODAY=HEUTE
TRANSPOSE=MTRANS
TREND=TREND
TRIM=GLÄTTEN
TRIMMEAN=GESTUTZTMITTEL
TRUE=WAHR
TRUNC=KÜRZEN
TTEST=TTEST
TYPE=TYP
UNION=UNION
UPPER=GROSS
VALUE=WERT
VAR=VARIANZ
VARA=VARIANZA
VARP=VARIANZEN
VARPA=VARIANZENA
VDB=VDB
VLOOKUP=SVERWEIS
WEEKDAY=WOCHENTAG
WEIBULL=WEIBULL
YEAR=JAHR
ZTEST=GTEST