ABS=ASS
ACOS=ARCCOS
ACOSH=ARCCOSH
ADDRESS=INDIRIZZO
AND=E
AREAS=AREE
ASIN=ARCSEN
ASINH=ARCSENH
ATAN=ARCTAN
ATAN2=ARCTAN.2
ATANH=ARCTANH
AVEDEV=MEDIA.DEV
AVERAGE=MEDIA
AVERAGEA=MEDIAA
BETADIST=DISTRIB.BETA
BETAINV=INV.BETA
BINOMDIST=DISTRIB.BINOM
CEILING=ARROTONDA.ECCESSO
CELL=CELLA
CHAR=CODICE.CARATT
CHIDIST=DISTRIB.CHI
CHIINV=INV.CHI
CHITEST=TEST.CHI
CHOOSE=SCEGLI
CLEAN=LIBERA
CODE=CODICE
COLUMN=RIF.COLONNA
COLUMNS=COLONNE
COMBIN=COMBINAZIONE
CONCATENATE=CONCATENA
CONFIDENCE=CONFIDENZA
CORREL=CORRELAZIONE
COS=COS
COSH=COSH
COUNT=CONTA.NUMERI
COUNTA=CONTA.VALORI
COUNTBLANK=CONTA.VUOTE
COUNTIF=CONTA.SE
COVAR=COVARIANZA
CRITBINOM=CRIT.BINOM
DATE=DATA
DATEVALUE=DATA.VALORE
DAVERAGE=DB.MEDIA
DAY=GIORNO
DAYS360=GIORNO360
DB=AMMORT.FISSO
DCOUNT=DB.CONTA.NUMERI
DCOUNTA=DB.CONTA.VALORI
DDB=AMMORT
DEGREES=GRADI
DEVSQ=DEV.Q
DGET=DB.VALORI
DMAX=DB.MAX
DMIN=DB.MIN
DOLLAR=VALUTA
DPRODUCT=DB.PRODOTTO
DSTDEV=DB.DEV.ST
DSTDEVP=DB.DEV.ST.POP
DSUM=DB.SOMMA
DVAR=DB.VAR
DVARP=DB.VAR.POP
ERROR.TYPE=ERRORE.TIPO
EVEN=PARI
EXACT=IDENTICO
EXP=EXP
EXPONDIST=DISTRIB.EXP
FACT=FATTORIALE
FALSE=FALSO
FDIST=DISTRIB.F
FIND=TROVA
FINV=INV.F
FISHER=FISHER
FISHERINV=INV.FISHER
FIXED=FISSO
FLOOR=ARROTONDA.DIFETTO
FORECAST=PREVISIONE
FREQUENCY=FREQUENZA
FTEST=TEST.F
FV=VAL.FUT
GAMMADIST=DISTRIB.GAMMA
GAMMAINV=INV.GAMMA
GAMMALN=LN.GAMMA
GEOMEAN=MEDIA.GEOMETRICA
GETPIVOTDATA=GETPIVOTDATA
GROWTH=CRESCITA
HARMEAN=MEDIA.ARMONICA
HLOOKUP=CERCA.ORIZZ
HOUR=ORA
HYPERLINK=HYPERLINK
HYPGEOMDIST=DISTRIB.IPERGEOM
IF=SE
INDEX=INDICE
INDIRECT=INDIRETTO
INFO=AMBIENTE.INFO
INT=INT
INTERCEPT=INTERCETTA
INTERSECT=INTERSECT
IPMT=INTERESSI
IRR=TIR.COST
ISBLANK=VAL.VUOTO
ISERR=VAL.ERR
ISERROR=VAL.ERRORE
ISLOGICAL=VAL.LOGICO
ISNA=VAL.NON.DISP
ISNONTEXT=VAL.NON.TESTO
ISNUMBER=VAL.NUMERO
ISPMT=ISPMT
ISREF=VAL.RIF
ISTEXT=VAL.TESTO
KURT=CURTOSI
LARGE=GRANDE
LEFT=SINISTRA
LEN=LUNGHEZZA
LINEST=REGR.LIN
LN=LN
LOG=LOG
LOG10=LOG10
LOGEST=REGR.LOG
LOGINV=INV.LOGNORM
LOGNORMDIST=DISTRIB.LOGNORM
LOOKUP=CERCA
LOWER=MINUSC
MATCH=CONFRONTA
MAX=MAX
MAXA=MAXA
MDETERM=MATR.DETERM
MEDIAN=MEDIANA
MID=STRINGA.ESTRAI
MIN=MIN
MINA=MINA
MINUTE=MINUTO
MINVERSE=MATR.INVERSA
MIRR=TIR.VAR
MMULT=MATR.PRODOTTO
MOD=RESTO
MODE=MODA
MONTH=MESE
N=NUM
NA=NON.DISP
NEGBINOMDIST=DISTRIB.BINOM.NEG
NORMDIST=DISTRIB.NORM
NORMINV=INV.NORM
NORMSDIST=DISTRIB.NORM.ST
NORMSINV=INV.NORM.ST
NOT=NON
NOW=ADESSO
NPER=NUM.RATE
NPV=VAN
ODD=DISPARI
OFFSET=SCARTO
OR=O
PEARSON=PEARSON
PERCENTILE=PERCENTILE
PERCENTRANK=PERCENT.RANGO
PERMUT=PERMUTAZIONE
PI=PI.GRECO
PMT=RATA
POISSON=POISSON
POWER=POTENZA
PPMT=P.RATA
PROB=PROBABILITÃ€
PRODUCT=PRODOTTO
PROPER=MAIUSC.INIZ
PV=VA
QUARTILE=QUARTILE
RADIANS=RADIANTI
RAND=CASUALE
RANK=RANGO
RATE=TASSO
REPLACE=RIMPIAZZA
REPT=RIPETI
RIGHT=DESTRA
ROMAN=ROMANO
ROUND=ARROTONDA
ROUNDDOWN=ARROTONDA.PER.DIF
ROUNDUP=ARROTONDA.PER.ECC
ROW=RIF.RIGA
ROWS=RIGHE
RSQ=RQ
RTD=RTD
SEARCH=RICERCA
SECOND=SECONDO
SIGN=SEGNO
SIN=SEN
SINH=SENH
SKEW=ASIMMETRIA
SLN=AMMORT.COST
SLOPE=PENDENZA
SMALL=PICCOLO
SQRT=RADQ
STANDARDIZE=NORMALIZZA
STDEV=DEV.ST
STDEVA=DEV.STA
STDEVP=DEV.ST.POP
STDEVPA=DEV.ST.POPA
STEYX=ERR.STD.YX
SUBSTITUTE=SOSTITUISCI
SUBTOTAL=SUBTOTALE
SUM=SOMMA
SUMIF=SOMMA.SE
SUMPRODUCT=MATR.SOMMA.PRODOTTO
SUMSQ=SOMMA.Q
SUMX2MY2=SOMMA.DIFF.Q
SUMX2PY2=SOMMA.SOMMA.Q
SUMXMY2=SOMMA.Q.DIFF
SYD=AMMORT.ANNUO
T=T
TAN=TAN
TANH=TANH
TDIST=DISTRIB.T
TEXT=TESTO
TIME=ORARIO
TIMEVALUE=ORARIO.VALORE
TINV=INV.T
TODAY=OGGI
TRANSPOSE=MATR.TRASPOSTA
TREND=TENDENZA
TRIM=ANNULLA.SPAZI
TRIMMEAN=MEDIA.TRONCATA
TRUE=VERO
TRUNC=TRONCA
TTEST=TEST.T
TYPE=TIPO
UNION=UNION
UPPER=MAIUSC
VALUE=VALORE
VAR=VAR
VARA=VARA
VARP=VAR.POP
VARPA=VAR.POPA
VDB=AMMORT.VAR
VLOOKUP=CERCA.VERT
WEEKDAY=GIORNO.SETTIMANA
WEIBULL=WEIBULL
YEAR=ANNO
ZTEST=TEST.Z