ABS=ABS
ACOS=ACOS
ACOSH=ACOSH
ADDRESS=ENDEREÇO
AND=E
AREAS=AREAS
ASIN=ASEN
ASINH=ASENH
ATAN=ATAN
ATAN2=ATAN2
ATANH=ATANH
AVEDEV=DESV.MÉDIO
AVERAGE=MÉDIA
AVERAGEA=MÉDIAA
BETADIST=DISTBETA
BETAINV=BETA.ACUM.INV
BINOMDIST=DISTRBINOM
CEILING=TETO
CELL=CÉ
CHAR=CARACT
CHIDIST=DIST.QUI
CHIINV=INV.QUI
CHITEST=TESTE.QUI
CHOOSE=ESCOLHER
CLEAN=TIRAR
CODE=CÓDIGO
COLUMN=CO
COLUMNS=COLS
COMBIN=COMBIN
CONCATENATE=CONCATENAR
CONFIDENCE=INT.CONFIANÇA
CORREL=CORRE
COS=COS
COSH=COSH
COUNT=CONT.NÚM
COUNTA=CONT.VALORES
COUNTBLANK=CONTAR.VAZIO
COUNTIF=CONT.SE
COVAR=COVAR
CRITBINOM=CRIT.BINOM
DATE=DATA
DATEVALUE=DATA.VALOR
DAVERAGE=BDMÉDIA
DAY=DIA
DAYS360=DIAS360
DB=BD
DCOUNT=BDCONTAR
DCOUNTA=BDCONTARA
DDB=BDD
DEGREES=GRAUS
DEVSQ=DESVQ
DGET=BDEXTRAIR
DMAX=BDMÁX
DMIN=BDMÍN
DOLLAR=MOEDA
DPRODUCT=BDMULTIP
DSTDEV=BDEST
DSTDEVP=BDDESVPA
DSUM=BDSOMA
DVAR=BDVAREST
DVARP=BDVARP
ERROR.TYPE=TIPO.ERRO
EVEN=PAR
EXACT=EXATO
EXP=EXP
EXPONDIST=DISTEXPON
FACT=FATORIA
FALSE=FALSO
FDIST=DISTF
FIND=PROCURAR
FINV=INVF
FISHER=FISHER
FISHERINV=FISHERINV
FIXED=DEF.NÚM.DEC
FLOOR=ARREDMULTB
FORECAST=PREVISÃO
FREQUENCY=FREQÜÊNCIA
FTEST=TESTEF
FV=VF
GAMMADIST=DISTGAMA
GAMMAINV=INVGAMA
GAMMALN=LNGAMA
GEOMEAN=MÉDIA.GEOMÉTRICA
GETPIVOTDATA=GETPIVOTDATA
GROWTH=CRESCIMENTO
HARMEAN=MÉDIA.HARMÔNICA
HLOOKUP=PROCH
HOUR=HORA
HYPERLINK=HYPERLINK
HYPGEOMDIST=DIST.HIPERGEOM
IF=SE
INDEX=ÍNDICE
INDIRECT=INDIRETO
INFO=INFORMAÇÃO
INT=INT
INTERCEPT=INTERCEPÇÃO
INTERSECT=INTERSECT
IPMT=IPGTO
IRR=TIR
ISBLANK=ÉCÉL.VAZIA
ISERR=ÉERRO
ISERROR=ÉERROS
ISLOGICAL=ÉLÓGICO
ISNA=É.NÃO.DISP
ISNONTEXT=É.NÃO.TEXTO
ISNUMBER=ÉNÚM
ISPMT=ÉPGTO
ISREF=ÉREF
ISTEXT=ÉTEXTO
KURT=CURT
LARGE=MAIOR
LEFT=ESQUERDA
LEN=NÚM.CARACT
LINEST=PROJ.LIN
LN=LN
LOG=LOG
LOG10=LOG10
LOGEST=PROJ.LOG
LOGINV=INVLOG
LOGNORMDIST=DIST.LOGNORMA
LOOKUP=PROC
LOWER=MINÚSCULA
MATCH=CORRESP
MAX=MÁXIMO
MAXA=MÁXIMOA
MDETERM=MATRIZ.DETERM
MEDIAN=MED
MID=EXT.TEXTO
MIN=MÍNIMO
MINA=MÍNIMOA
MINUTE=MINUTO
MINVERSE=MATRIZ.INVERSO
MIRR=MTIR
MMULT=MATRIZ.MULT
MOD=MOD
MODE=MODO
MONTH=MÊS
N=N
NA=NÃO.DISP
NEGBINOMDIST=DIST.BIN.NEG
NORMDIST=DIST.NORM
NORMINV=INV.NORM
NORMSDIST=DIST.NORMP
NORMSINV=INV.NORMP
NOT=NÃO
NOW=AGORA
NPER=NPER
NPV=VP
ODD=ÍMPAR
OFFSET=DESLOC
OR=OU
PEARSON=PEARSON
PERCENTILE=PERCENTI
PERCENTRANK=ORDEM.PORCENTUA
PERMUT=PERMUT
PI=PI
PMT=PGTO
POISSON=POISSON
POWER=POTÊNCIA
PPMT=PPGTO
PROB=PROB
PRODUCT=MULT
PROPER=PRI.MAIÚSCULA
PV=VP
QUARTILE=QUARTI
RADIANS=RADIANOS
RAND=ALEATÓRIO
RANK=ORDEM
RATE=TAXA
REPLACE=MUDAR
REPT=REPETIR
RIGHT=DIREITA
ROMAN=ROMANO
ROUND=ARRED
ROUNDDOWN=ARREDONDAR.PARA.BAIXO
ROUNDUP=ARREDONDAR.PARA.CIMA
ROW=LIN
ROWS=LINS
RSQ=RQUAD
RTD=RTD
SEARCH=LOCALIZAR
SECOND=SEGUNDO
SIGN=SINA
SIN=SEN
SINH=SENH
SKEW=DISTORÇÃO
SLN=DPD
SLOPE=INCLINAÇÃO
SMALL=MENOR
SQRT=RAIZ
STANDARDIZE=PADRONIZAR
STDEV=DESVPAD
STDEVA=DESVPADA
STDEVP=DESVPADP
STDEVPA=DESVPADPA
STEYX=EPADYX
SUBSTITUTE=SUBSTITUIR
SUBTOTAL=SUBTOTA
SUM=SOMA
SUMIF=SOMASE
SUMPRODUCT=SOMARPRODUTO
SUMSQ=SOMAQUAD
SUMX2MY2=SOMAX2DY2
SUMX2PY2=SOMAX2SY2
SUMXMY2=SOMAXMY2
SYD=SDA
T=T
TAN=TAN
TANH=TANH
TDIST=DISTT
TEXT=TEXTO
TIME=TEMPO
TIMEVALUE=VALOR.TEMPO
TINV=INVT
TODAY=HOJE
TRANSPOSE=TRANSPOR
TREND=TENDÊNCIA
TRIM=ARRUMAR
TRIMMEAN=MÉDIA.INTERNA
TRUE=VERDADEIRO
TRUNC=TRUNCAR
TTEST=TESTET
TYPE=TIPO
UNION=UNION
UPPER=MAIÚSCULA
VALUE=VALOR
VAR=VAR
VARA=VARA
VARP=VARP
VARPA=VARPA
VDB=BDV
VLOOKUP=PROCV
WEEKDAY=DIA.DA.SEMANA
WEIBULL=WEIBUL
YEAR=ANO
ZTEST=TESTEZ