ABS=ABS
ACOS=ACOS
ACOSH=ACOSH
ADDRESS=DIRECCION
AND=Y
AREAS=AREAS
ASIN=ASENO
ASINH=ASENOH
ATAN=ATAN
ATAN2=ATAN2
ATANH=ATANH
AVEDEV=DESVPROM
AVERAGE=PROMEDIO
AVERAGEA=PROMEDIOA
BETADIST=DISTR.BETA
BETAINV=DISTR.BETA.INV
BINOMDIST=DISTR.BINOM
CEILING=MULTIPLO.SUPERIOR
CELL=CELDA
CHAR=CARACTER
CHIDIST=DISTR.CHI
CHIINV=PRUEBA.CHI.INV
CHITEST=PRUEBA.CHI
CHOOSE=ELEGIR
CLEAN=LIMPIAR
CODE=CODIGO
COLUMN=COLUMNA
COLUMNS=COLUMNAS
COMBIN=COMBINAT
CONCATENATE=CONCATENAR
CONFIDENCE=INTERVALO.CONFIANZA
CORREL=COEF.DE.CORREL
COS=COS
COSH=COSH
COUNT=CONTAR
COUNTA=CONTARA
COUNTBLANK=CONTAR.BLANCO
COUNTIF=CONTAR.SI
COVAR=COVAR
CRITBINOM=BINOM.CRIT
DATE=FECHA
DATEVALUE=FECHANUMERO
DAVERAGE=BDPROMEDIO
DAY=DIA
DAYS360=DIAS360
DB=DB
DCOUNT=BDCONTAR
DCOUNTA=BDCONTARA
DDB=DDB
DEGREES=GRADOS
DEVSQ=DESVIA2
DGET=BDEXTRAER
DMAX=BDMAX
DMIN=BDMIN
DOLLAR=MONEDA
DPRODUCT=BDPRODUCTO
DSTDEV=BDDESVEST
DSTDEVP=BDDESVESTP
DSUM=BDSUMA
DVAR=BDVAR
DVARP=BDVARP
ERROR.TYPE=TIPO.DE.ERROR
EVEN=REDONDEA.PAR
EXACT=IGUAL
EXP=EXP
EXPONDIST=DISTR.EXP
FACT=FACT
FALSE=FALSO
FDIST=DISTR.F
FIND=ENCONTRAR
FINV=DISTR.F.INV
FISHER=FISHER
FISHERINV=PRUEBA.FISHER.INV
FIXED=DECIMAL
FLOOR=MULTIPLO.INFERIOR
FORECAST=PRONOSTICO
FREQUENCY=FRECUENCIA
FTEST=PRUEBA.F
FV=VF
GAMMADIST=DISTR.GAMMA
GAMMAINV=DISTR.GAMMA.INV
GAMMALN=GAMMA.LN
GEOMEAN=MEDIA.GEOM
GETPIVOTDATA=GETPIVOTDATA
GROWTH=CRECIMIENTO
HARMEAN=MEDIA.ARMO
HLOOKUP=BUSCARH
HOUR=HORA
HYPERLINK=HYPERLINK
HYPGEOMDIST=DISTR.HIPERGEOM
IF=SI
INDEX=INDICE
INDIRECT=INDIRECTO
INFO=INFO
INT=ENTERO
INTERCEPT=INTERSECCION
INTERSECT=INTERSECT
IPMT=PAGOINT
IRR=TIR
ISBLANK=ESBLANCO
ISERR=ESERR
ISERROR=ESERROR
ISLOGICAL=ESLOGICO
ISNA=ESNOD
ISNONTEXT=ESNOTEXTO
ISNUMBER=ESNUMERO
ISPMT=INT.PAGO.DIR
ISREF=ESREF
ISTEXT=ESTEXTO
KURT=CURTOSIS
LARGE=K.ESIMO.MAYOR
LEFT=IZQUIERDA
LEN=LARGO
LINEST=ESTIMACION.LINEAL
LN=LN
LOG=LOG
LOG10=LOG10
LOGEST=ESTIMACION.LOGARITMICA
LOGINV=DISTR.LOG.INV
LOGNORMDIST=DISTR.LOG.NORM
LOOKUP=BUSCAR
LOWER=MINUSC
MATCH=COINCIDIR
MAX=MAX
MAXA=MAXA
MDETERM=MDETERM
MEDIAN=MEDIANA
MID=EXTRAE
MIN=MIN
MINA=MINA
MINUTE=MINUTO
MINVERSE=MINVERSA
MIRR=TIRM
MMULT=MMULT
MOD=RESIDUO
MODE=MODA
MONTH=MES
N=N
NA=NOD
NEGBINOMDIST=NEGBINOMDIST
NORMDIST=DISTR.NORM
NORMINV=DISTR.NORM.INV
NORMSDIST=DISTR.NORM.ESTAND
NORMSINV=DISTR.NORM.ESTAND.INV
NOT=NO
NOW=AHORA
NPER=NPER
NPV=VNA
ODD=REDONDEA.IMPAR
OFFSET=DESREF
OR=O
PEARSON=PEARSON
PERCENTILE=PERCENTIL
PERCENTRANK=RANGO.PERCENTIL
PERMUT=PERMUTACIONES
PI=PI
PMT=PAGO
POISSON=POISSON
POWER=POTENCIA
PPMT=PAGOPRIN
PROB=PROBABILIDAD
PRODUCT=PRODUCTO
PROPER=NOMPROPIO
PV=VA
QUARTILE=CUARTIL
RADIANS=RADIANES
RAND=ALEATORIO
RANK=JERARQUIA
RATE=TASA
REPLACE=REEMPLAZAR
REPT=REPETIR
RIGHT=DERECHA
ROMAN=NUMERO.ROMANO
ROUND=REDONDEAR
ROUNDDOWN=REDONDEAR.MENOS
ROUNDUP=REDONDEAR.MAS
ROW=FILA
ROWS=FILAS
RSQ=COEFICIENTE.R2
RTD=RTD
SEARCH=HALLAR
SECOND=SEGUNDO
SIGN=SIGNO
SIN=SENO
SINH=SENOH
SKEW=COEFICIENTE.ASIMETRIA
SLN=SLN
SLOPE=PENDIENTE
SMALL=K.ESIMO.MENOR
SQRT=RAIZ
STANDARDIZE=NORMALIZACION
STDEV=DESVEST
STDEVA=DESVESTA
STDEVP=DESVESTP
STDEVPA=DESVESTPA
STEYX=ERROR.TIPICO.XY
SUBSTITUTE=SUSTITUIR
SUBTOTAL=SUBTOTALES
SUM=SUMA
SUMIF=SUMAR.SI
SUMPRODUCT=SUMAPRODUCTO
SUMSQ=SUMA.CUADRADOS
SUMX2MY2=SUMAX2MENOSY2
SUMX2PY2=SUMAX2MASY2
SUMXMY2=SUMAXMENOSY2
SYD=SYD
T=T
TAN=TAN
TANH=TANH
TDIST=DISTR.T
TEXT=TEXTO
TIME=NSHORA
TIMEVALUE=HORANUMERO
TINV=DISTR.T.INV
TODAY=HOY
TRANSPOSE=TRANSPONER
TREND=TENDENCIA
TRIM=ESPACIOS
TRIMMEAN=MEDIA.ACOTADA
TRUE=VERDADERO
TRUNC=TRUNCAR
TTEST=PRUEBA.T
TYPE=TIPO
UNION=UNION
UPPER=MAYUSC
VALUE=VALOR
VAR=VAR
VARA=VARA
VARP=VARP
VARPA=VARPA
VDB=DVS
VLOOKUP=BUSCARV
WEEKDAY=DIASEM
WEIBULL=DIST.WEIBULL
YEAR=AÃ‘O
ZTEST=PRUEBA.Z