ABS=ABS
ACOS=ACOS
ACOSH=ACOSH
ADDRESS=ADRESSE
AND=ET
AREAS=ZONES
ASIN=ASIN
ASINH=ASINH
ATAN=ATAN
ATAN2=ATAN2
ATANH=ATANH
AVEDEV=ECART.MOYEN
AVERAGE=MOYENNE
AVERAGEA=AVERAGEA
BETADIST=LOI.BETA
BETAINV=BETA.INVERSE
BINOMDIST=LOI.BINOMIALE
CEILING=PLAFOND
CELL=CELLULE
CHAR=CAR
CHIDIST=LOI.KHIDEUX
CHIINV=KHIDEUX.INVERSE
CHITEST=TEST.KHIDEUX
CHOOSE=CHOISIR
CLEAN=EPURAGE
CODE=CODE
COLUMN=COLONNE
COLUMNS=COLONNES
COMBIN=COMBIN
CONCATENATE=CONCATENER
CONFIDENCE=INTERVALLE.CONFIANCE
CORREL=COEFFICIENT.CORRELATION
COS=COS
COSH=COSH
COUNT=NB
COUNTA=NBVAL
COUNTBLANK=NB.VIDE
COUNTIF=NB.SI
COVAR=COVARIANCE
CRITBINOM=CRITERE.LOI.BINOMIALE
DATE=DATE
DATEVALUE=DATEVAL
DAVERAGE=BDMOYENNE
DAY=JOUR
DAYS360=JOURS360
DB=DB
DCOUNT=BDNB
DCOUNTA=BDNBVAL
DDB=DDB
DEGREES=DEGRES
DEVSQ=SOMME.CARRE.ECARTS
DGET=BDLIRE
DMAX=BDMAX
DMIN=BDMIN
DOLLAR=FRANC
DPRODUCT=BDPRODUIT
DSTDEV=BDECARTTYPE
DSTDEVP=BDECARTTYPEP
DSUM=BDSOMME
DVAR=BDVAR
DVARP=BDVARP
ERROR.TYPE=TYPE.ERREUR
EVEN=PAIR
EXACT=EXACT
EXP=EXP
EXPONDIST=LOI.EXPONENTIELLE
FACT=FACT
FALSE=FAUX
FDIST=LOI.F
FIND=TROUVE
FINV=INSERVE.LOI.F
FISHER=FISHER
FISHERINV=FISHER.INVERSE
FIXED=CTXT
FLOOR=PLANCHER
FORECAST=PREVISION
FREQUENCY=FREQUENCE
FTEST=TEST.F
FV=VC
GAMMADIST=LOI.GAMMA
GAMMAINV=LOI.GAMMA.INVERSE
GAMMALN=LNGAMMA
GEOMEAN=MOYENNE.GEOMETRIQUE
GETPIVOTDATA=LIREDONNEESTABCROISDYNAMIQUE
GROWTH=CROISSANCE
HARMEAN=MOYENNE.HARMONIQUE
HLOOKUP=RECHERCHEH
HOUR=HEURE
HYPERLINK=LIEN_HYPERTEXTE
HYPGEOMDIST=LOI.HYPERGEOMETRIQUE
IF=SI
INDEX=INDEX
INDIRECT=INDIRECT
INFO=INFO
INT=ENT
INTERCEPT=ORDONNEE.ORIGINE
INTERSECT=INTERSECTION
IPMT=INTPER
IRR=TRI
ISBLANK=ESTVIDE
ISERR=ESTERR
ISERROR=ESTERREUR
ISLOGICAL=ESTLOGIQUE
ISNA=ESTNA
ISNONTEXT=ESTNONTEXTE
ISNUMBER=ESTNUM
ISPMT=ISPMT
ISREF=ESTREF
ISTEXT=ESTTEXTE
KURT=KURTOSIS
LARGE=GRANDE.VALEUR
LEFT=GAUCHE
LEN=NBCAR
LINEST=DROITEREG
LN=LN
LOG=LOG
LOG10=LOG10
LOGEST=LOGREG
LOGINV=LOI.LOGNORMALE.INVERSE
LOGNORMDIST=LOI.LOGNORMALE
LOOKUP=RECHERCHE
LOWER=MINUSCULE
MATCH=EQUIV
MAX=MAX
MAXA=MAXA
MDETERM=DETERMAT
MEDIAN=MEDIANE
MID=STXT
MIN=MIN
MINA=MINA
MINUTE=MINUTE
MINVERSE=INVERSEMAT
MIRR=MTRI
MMULT=PRODUITMAT
MOD=MOD
MODE=MODE
MONTH=MOIS
N=N
NA=NA
NEGBINOMDIST=LOI.BINOMIALE.NEG
NORMDIST=LOI.NORMALE
NORMINV=LOI.NORMALE.INVERSE
NORMSDIST=LOI.NORMALE.STANDARD
NORMSINV=LOI.NORMALE.STANDARD.INVERSE
NOT=NON
NOW=MAINTENANT
NPER=NPM
NPV=VAN
ODD=IMPAIR
OFFSET=DECALER
OR=OU
PEARSON=PEARSON
PERCENTILE=CENTILE
PERCENTRANK=RANG.POURCENTAGE
PERMUT=PERMUTATION
PI=PI
PMT=VPM
POISSON=LOI.POISSON
POWER=PUISSANCE
PPMT=PRINCPER
PROB=PROBABILITE
PRODUCT=PRODUIT
PROPER=NOMPROPRE
PV=VA
QUARTILE=QUARTILE
RADIANS=RADIANS
RAND=ALEA
RANK=RANG
RATE=TAUX
REPLACE=REMPLACER
REPT=REPT
RIGHT=DROITE
ROMAN=ROMAIN
ROUND=ARRONDI
ROUNDDOWN=ARRONDI.INF
ROUNDUP=ARRONDI.SUP
ROW=LIGNE
ROWS=LIGNES
RSQ=COEFFICIENT.DETERMINATION
RTD=RTD
SEARCH=CHERCHE
SECOND=SECONDE
SIGN=SIGNE
SIN=SIN
SINH=SINH
SKEW=COEFFICIENT.ASYMETRIE
SLN=AMORLIN
SLOPE=PENTE
SMALL=PETITE.VALEUR
SQRT=RACINE
STANDARDIZE=CENTREE.REDUITE
STDEV=ECARTYPE
STDEVA=STDEVA
STDEVP=ECARTYPEP
STDEVPA=STDEVPA
STEYX=ERREUR.TYPE.XY
SUBSTITUTE=SUBSTITUE
SUBTOTAL=SOUS.TOTAL
SUM=SOMME
SUMIF=SOMME.SI
SUMPRODUCT=SOMMEPROD
SUMSQ=SOMME.CARRES
SUMX2MY2=SOMME.X2MY2
SUMX2PY2=SOMME.X2PY2
SUMXMY2=SOMME.XMY2
SYD=SYD
T=T
TAN=TAN
TANH=TANH
TDIST=LOI.STUDENT
TEXT=TEXTE
TIME=TEMPS
TIMEVALUE=TEMPSVAL
TINV=LOI.STUDENT.INVERSE
TODAY=AUJOURDHUI
TRANSPOSE=TRANSPOSE
TREND=TENDANCE
TRIM=SUPPRESPACE
TRIMMEAN=MOYENNE.REDUITE
TRUE=VRAI
TRUNC=TRONQUE
TTEST=TEST.STUDENT
TYPE=TYPE
UNION=UNION
UPPER=MAJUSCULE
VALUE=CNUM
VAR=VAR
VARA=VARA
VARP=VAR.P
VARPA=VARPA
VDB=VDB
VLOOKUP=RECHERCHEV
WEEKDAY=JOURSEM
WEIBULL=LOI.WEIBULL
YEAR=ANNEE
ZTEST=TEST.Z
