ACCRINT=НАКОПДОХОД
ADDRESS=АДРЕС
AMORDEGRC=АМОРУМ
AMORLINC=АМОРУВ
AND=И
AREAS=ОБЛАСТИ
AVEDEV=СРОТКЛ
AVERAGE=СРЗНАЧ
BIN2DEC=ДВ.В.ДЕС
BIN2HEX=ДВ.В.ШЕСТН
BIN2OCT=ДВ.В.ВОСЬМ
BINOMDIST=БИНОМРАСП
CEILING=ОКРВВЕРХ
CELL=ЯЧЕЙКА
CHAR=СИМВОЛ
CHOOSE=ВЫБОР
CLEAN=ПЕЧСИМВ
CODE=КОДСИМВ
COLUMN=СТОЛБЕЦ
COLUMNS=ЧИСЛСТОЛБ
COMPLEX=КОМПЛЕКСН
CONCATENATE=СЦЕПИТЬ
CONFIDENCE=ДОВЕРИТ
COUNT=СЧЁТ
COUNTA=СЧЁТЗ
COUNTBLANK=СЧИТАТЬПУСТОТЫ
COUNTIF=СЧЁТЕСЛИ
COUPDAYBS=ДНЕЙКУПОНДО
COUPDAYS=ДНЕЙКУПОН
COUPDAYSNC=ДНЕЙКУПОНПОСЛЕ
COUPNCD=ДАТАКУПОНПОСЛЕ
COUPNUM=ЧИСЛКУПОН
COUPPCD=ДАТАКУПОНДО
CUMIPMT=ОБЩПЛАТ
CUMPRINC=ОБЩДОХОД
DATE=ДАТА
DATEVALUE=ДАТАЗНАЧ
DAVERAGE=ДСРЗНАЧ
DAY=ДЕНЬ
DAYS360=ДНЕЙ360
DB=ДОБ
DCOUNT=БСЧЁТ
DCOUNTA=БСЧЁТА
DDB=ДДОБ
DEC2BIN=ДЕС.В.ДВ
DEC2HEX=ДЕС.В.ШЕСТН
DEC2OCT=ДЕС.В.ВОСЬМ
DEGREES=ГРАДУСЫ
DELTA=ДЕЛЬТА
DEVSQ=КВАДРОТКЛ
DGET=БИЗВЛЕЧЬ
DISC=СКИДКА
DMAX=ДМАКС
DMIN=ДМИН
DOLLAR=РУБЛЬ
DOLLARDE=РУБЛЬ.ДЕС
DOLLARFR=РУБЛЬ.ДРОБЬ
DPRODUCT=БДПРОИЗВЕД
DSTDEV=ДСТАНДОТКЛ
DSTDEVP=ДСТАНДОТКЛП
DSUM=БДСУММ
DURATION=ДЛИТ
DVAR=БДДИСП
DVARP=БДДИСПП
EDATE=ДАТАМЕС
EFFECT=ЭФФЕКТ
EOMONTH=КОНЕЦМЕСЯЦА
ERF=ФОШ
ERFC=ДФОШ
ERROR.TYPE=ТИП.ОШИБКИ
EVEN=ЧЁТН
EXACT=СОВПАД
EXPONDIST=ЭКСПРАСП
FACT=ФАКТР
FACTDOUBLE=ДВФАКТР
FIND=НАЙТИ
FIXED=ФИКСИРОВАННЫЙ
FLOOR=ОКРВНИЗ
FREQUENCY=ЧАСТОТА
FVSCHEDULE=БЗРАСПИС
GAMMADIST=ГАММАРАСП
GAMMAINV=ГАММАОБР
GAMMALN=ГАММАНЛОГ
GCD=НОД
GESTEP=ПОРОГ
HEX2BIN=ШЕСТН.В.ДВ
HEX2DEC=ШЕСТН.В.ДЕС
HEX2OCT=ШЕСТН.В.ВОСЬМ
HLOOKUP=ГПР
HOUR=ЧАС
HYPGEOMDIST=ГИПЕРГЕОМЕТ
IF=ЕСЛИ
IMABS=МНИМ.ABS
IMAGINARY=МНИМ.ЧАСТЬ
IMARGUMENT=МНИМ.АРГУМЕНТ
IMCONJUGATE=МНИМ.СОПРЯЖ
IMCOS=МНИМ.COS
IMDIV=МНИМ.ДЕЛ
IMEXP=МНИМ.EXP
IMLN=МНИМ.LN
IMLOG10=МНИМ.LOG10
IMLOG2=МНИМ.LOG2
IMPOWER=МНИМ.СТЕПЕНЬ
IMPRODUCT=МНИМ.ПРОИЗВЕД
IMREAL=МНИМ.ВЕЩ
IMSIN=МНИМ.SIN
IMSQRT=МНИМ.КОРЕНЬ
IMSUB=МНИМ.РАЗН
IMSUM=МНИМ.СУММ
INDEX=ИНДЕКС
INDIRECT=ДВССЫЛ
INFO=ИНФОРМ
INT=ЦЕЛОЕ
INTRATE=ИНОРМА
IPMT=ПЛПРОЦ
IRR=ВНДОХ
ISBLANK=ЕПУСТО
ISERR=ЕОШ
ISERROR=ЕОШИБКА
ISEVEN=ЕЧЁТН
ISLOGICAL=ЕЛОГИЧ
ISNA=ЕНД
ISNONTEXT=ЕНЕТЕКСТ
ISNUMBER=ЕЧИСЛО
ISODD=ЕНЕЧЁТ
ISREF=ЕССЫЛКА
ISTEXT=ЕТЕКСТ
KURT=ЭКСЦЕСС
LARGE=НАИБОЛЬШИЙ
LCM=НОК
LEFT=ЛЕВСИМВ
LEN=ДЛСТР
LINEST=ЛИНЕЙН
LOGEST=ЛГРФПРИБЛ
LOOKUP=ПРОСМОТР
LOWER=СТРОЧН
MATCH=ПОИСКПОЗ
MAX=МАКС
MDETERM=МОПРЕД
MEDIAN=МЕДИАНА
MID=ПСТР
MIN=МИН
MINUTE=МИНУТЫ
MINVERSE=МОБР
MIRR=ИВСД
MMULT=МУМНОЖ
MOD=ОСТАТ
MONTH=МЕСЯЦ
MROUND=ОКРУГЛТ
N=Ч
NA=НД
NETWORKDAYS=ЧИСТРАБДНИ
NOMINAL=НОМИНАЛ
NOT=НЕ
NOW=ТДАТА
NPER=КПЕР
NPV=НПЗ
OCT2BIN=ВОСЬМ.В.ДВ
OCT2DEC=ВОСЬМ.В.ДЕС
OCT2HEX=ВОСЬМ.В.ШЕСТН
ODD=НЕЧЁТ
ODDFPRICE=ЦЕНАПЕРНЕРЕГ
ODDFYIELD=ДОХОДПЕРВНЕРЕГ
ODDLPRICE=ЦЕНАПОСЛНЕРЕГ
ODDLYIELD=ДОХОДПОСЛНЕРЕГ
OFFSET=СМЕЩ
OR=ИЛИ
PERCENTRANK=ПРОЦЕНТРАНГ
PERMUT=ПЕРЕСТ
PI=ПИ
PMT=ППЛАТ
POWER=СТЕПЕНЬ
PPMT=ОСНПЛАТ
PRICE=ЦЕНА
PRICEDISC=ЦЕНАСКИДКА
PRICEMAT=ЦЕНАПОГАШ
PROB=ВЕРОЯТНОСТЬ
PRODUCT=ПРОИЗВЕД
PV=ПЗ
QUOTIENT=ЧАСТНОЕ
RADIANS=РАДИАНЫ
RAND=СЛЧИС
RANDBETWEEN=СЛУЧМЕЖДУ
RANK=РАНГ
RATE=НОРМА
RECEIVED=ПОЛУЧЕНО
REPLACE=ЗАМЕНИТЬ
REPT=ПОВТОР
RIGHT=ПРАВСИМВ
ROMAN=РИМСКОЕ
ROUND=ОКРУГЛ
ROUNDDOWN=ОКРУГЛВНИЗ
ROUNDUP=ОКРУГЛВВЕРХ
ROW=СТРОКА
ROWS=ЧСТРОК
SEARCH=ПОИСК
SECOND=СЕКУНДЫ
SERIESSUM=РЯД.СУМ
SIGN=ЗНАК
SLOPE=НАКЛОН
SMALL=НАИМЕНЬШИЙ
SQRT=КОРЕНЬ
SQRTPI=КОРЕНЬПИ
STANDARDIZE=НОРМАЛИЗАЦИЯ
STDEV=СТАНДОТКЛОН
STEYX=СТОШYX
SUBSTITUTE=ПОДСТАВИТЬ
SUBTOTAL=ПРОМЕЖУТОЧНЫЕ.ИТОГИ
SUM=СУММ
SUMIF=СУММЕСЛИ
SUMPRODUCT=СУММПРОИЗВ
SUMSQ=СУММКВ
SUMX2MY2=СУММРАЗНКВ
SUMX2PY2=СУММСУММКВ
SUMXMY2=СУММКВРАЗН
SYD=АМГД
T=Т
TBILLEQ=РАВНОКЧЕК
TBILLPRICE=ЦЕНАКЧЕК
TBILLYIELD=ДОХОДЧЕК
TEXT=ТЕКСТ
TIME=ВРЕМЯ
TIMEVALUE=ВРЕМЗНАЧ
TODAY=СЕГОДНЯ
TRANSPOSE=ТРАНСП
TREND=ТЕНДЕНЦИЯ
TRIM=СЖПРОБЕЛЫ
TRIMMEAN=УРЕСРЕДНЕЕ
TRUNC=ОТБР
TYPE=ТИП
UPPER=ПРОПИСН
VALUE=ЗНАЧЕН
VAR=ДИСП
VARP=ДИСПР
VDB=ПДОБ
VLOOKUP=ВПР
WEEKDAY=ДЕНЬНЕД
WORKDAY=РАБДЕНЬ
XIRR=ЧИСТВНДОХ
XNPV=ЧИСТНЗ
YEAR=ГОД
YEARFRAC=ДОЛЯГОДА
YIELD=ДОХОД
YIELDDISC=ДОХОДСКИДКА
YIELDMAT=ДОХОДПОГАШ
FALSE=ЛОЖЬ
TRUE=ИСТИНА
ABS=ABS
ACOSH=ACOSH
ACOS=ACOS
ASINH=ASINH
ASIN=ASIN
ATAN2=ATAN2
ATANH=ATANH
ATAN=ATAN
COSH=COSH
COS=COS
EXP=EXP
LN=LN
LOG10=LOG10
LOG=LOG
SINH=SINH
TANH=TANH
TAN=TAN
